{
  "width": 5,
  "height": 5,
  "groundLayer": [
    [9, 9, 9, 9, 9, 9, 9, 9, 9, 9, 9, 9, 9, 9, 9],
    [9, 1, 2, 2, 2, 2, 2, 2, 2, 2, 2, 2, 2, 3, 9],
    [9, 8, 0, 0, 0, 0, 0, 0, 0 ,0 ,0 ,0 ,0, 4, 9],
    [9, 8, 0, 0, 0, 0, 0, 0, 0 ,0 ,0 ,0 ,0, 4, 9],
    [9, 8, 0, 0, 0, 0, 0, 0, 0 ,0 ,0 ,0 ,0, 4, 9],
    [9, 8, 0, 0, 0, 0, 0, 0, 0 ,0 ,0 ,0 ,0, 4, 9],
    [9, 8, 0, 0, 0, 0, 0, 0, 0 ,0 ,0 ,0 ,0, 4, 9],
    [9, 8, 0, 0, 0, 0, 0, 0, 0 ,0 ,0 ,0 ,0, 4, 9],
    [9, 8, 0, 0, 0, 0, 0, 0, 0 ,0 ,0 ,0 ,0, 4, 9],
    [9, 8, 0, 0, 0, 0, 0, 0, 0 ,0 ,0 ,0 ,0, 4, 9],
    [9, 8, 0, 0, 0, 0, 0, 0, 0 ,0 ,0 ,0 ,0, 4, 9],
    [9, 8, 0, 0, 0, 0, 0, 0, 0 ,0 ,0 ,0 ,0, 4, 9],
    [9, 8, 0, 0, 0, 0, 0, 0, 0 ,0 ,0 ,0 ,0, 4, 9],
    [9, 8, 0, 0, 0, 0, 0, 0, 0 ,0 ,0 ,0 ,0, 4, 9],
    [9, 7, 6, 6, 6, 6, 6, 6, 6, 6, 6, 6, 6, 5, 9],
    [9, 9, 9, 9, 9, 9, 9, 9, 9, 9, 9, 9, 9, 9, 9]
  ],
  "objectLayer": [
    [0, 0, 0, 0, 0],
    [0, 2, 2, 0, 0],
    [0, 2, 0, 0, 0],
    [0, 0, 0, 3, 0],
    [0, 0, 0, 0, 0]
  ],
  "resourceLayer": [
    [0, 0, 0, 0, 0],
    [0, 0, 1, 0, 0],
    [0, 0, 0, 0, 0],
    [0, 0, 0, 0, 0],
    [0, 0, 0, 0, 0]
  ]
}
